meet met met - встречать
strike struck struck - (удар, врезаться, забастовка, ударить, бить)
pay paid paid - платить
lean leant leaned - (наклоняться, прислоняться)
forgive forgave forgiven - прощать
cost cost cost - стоить
cut cut cut - резать
rise rose risen - (подниматься, увеличение, повышение, рост)
go went gone - (идти, ехать)
do did done - делать
bend bent bent - (гнуть, наклоняться, изгибаться)
drive drove driven - (водить машину, ездить)
light lit lit - (зажигать, освещать)
beat beat beaten - бить(нанесение серии ударов, обычно повторяющихся и ритмичных)
grow grew grown - (расти, выращивать)
broadcast broadcast broadcast - транслировать
know knew known - знать
shine shone shone - (сиять, светить)
burst burst burst - (лопнуть, взорваться, разразиться, прорывать)
shoot shot shot - стрелять
spell spelt spelt - (произносить по буквам, сотворить закринание, объяснять или разъяснять)
learn learnt learnt - учить, изучать
thrust thrust thrust - (толкать, протягивать, выдвигать, продвигать, запускать)
sow sowed sown - сеять
stand stood stood - стоять
fall fell fallen - падать
quit quit quit - (остановиться, прекратить, отказаться, прекратиться, завершить, бросать, покидать)
feed fed fed - кормить
send sent sent - (отправлять, посылать)
shrink shrank shrunk - (уменьшаться, сокращаться) в размере, обьеме.
sing sang sung - петь
weave wove woven - ткать
sell sold sold - продавать
hold held held - (держать,  поддерживать)
read read read - читать
slide slid slid - скользить
wind wound wound - (извиваться, обматывать, заводить)
break broke broken - ломать
leave left left - оставлять
creep crept crept - (ползать, ползти)
lay laid laid - (класть, прокладывать)
lose lost lost - терять
forbid forbade forbidden - запрещать
hit hit hit - (ударять, бить) какой то 1 сильный удар  или столкновение с чем-то. 
win won won - выигрывать
stick stuck stuck - (колоть, прикалывать, прикреплять, застревать)
run ran run - бежать
cast cast cast - (отбрасывать, бросать, метать, поручать)
hang hung hung - (висеть, вешать)
show showed shown - показывать
bring brought brought - (приносить, приводить)
bite bit bitten - кусать
draw drew drawn - рисовать
become became become - (становиться, превращаться)
can could been able - могти
abide abode abode - (мириться, соблюдать)
swing swung swung - (качать, качаться, колебание)
come came come - (приходить, приезжать)
tell told told - (рассказывать, говорить)
ride rode ridden - ездить
swear swore sworn - (клясться, ругаться)
hurt hurt hurt - причинять боль
write wrote written - писать
fight fought fought - бороться
keep kept kept - (держать, сохранять, хранить)
mean meant meant - (значить, предназначать, иметь в виду)
deal dealt dealt - (иметь дело, сделка)
ring rang rung - (звук звонка, звон колоколов, сигнал вызова)
steal stole stolen - (красть, захватить )
understand understood understood - понимать
swim swam swum - плавать
spill spilt spilt - пролить
seek sought sought - (стремиться, добиваться, искать)
sting stung stung - жалить
feel felt felt - чувствовать
sleep slept slept - спать
beseech besought besought - (просить, умолять)
sweep swept swept - (мести, подметать)
knit knit knit - вязать
begin began begun - начинать
mow mowed mown - (косить, стричь)
fly flew flown - летать
flee fled fled - (бежать, скрыться)
find found found - находить
lend lent lent - давать взаймы
forget forgot forgotten - забывать
spin span spun - (вращаться, прясть)
hear heard heard - слышать
choose chose chosen - выбирать
bet bet bet - (делать ставку, держать пари)
spoil spoilt spoilt - (портить, добыча, испортить)
sink sank sunk - (тонуть, топить)
swell swelled swollen - разбухать
make made made - (сделать, делать, совершать, производить)
weep wept wept - плакать(выражение горя или печали, которое часто сопровождается звуками и слезами)
let let let - (пускать, позволять)
be was/were been - быть
bear bore born - (нести, выдерживать или терпеть что-либо)
burn burnt burnt - (сжигать, гореть)
strive strove striven - стремиться
lead led led - вести(показывать путь)
wake woke woken - (будить, просыпаться)
set set set - (устанавливать, ставить)
wear wore worn - носить
prove proved proven - доказывать
speed sped sped - скорость
dream dreamt dreamt - (мечтать, сниться)
sit sat sat - (сидеть, садиться)
drink drank drunk - пить
put put put - (ставить, класть)
smell smelt smelt - (пахнуть, нюхать)
get got got - получать
blow blew blown - дуть
leap leapt leapt - (скачок, прыжок, прорыв)
arise arose arisen - появляться
see saw seen - видеть
breed bred bred - (размножаться, разводить, воспитывать, порода)
build built built - строить
take took taken - брать
lie lay lain - лежать
shake shook shaken - встряхивать
saw sawed sawn - пилить
tear tore torn - (рвать, разрыв)
eat ate eaten - есть
dwell dwelt dwelt - (жить, поселить, обитають, находиться)
wring wrung wrung - (отжать, свернуть, вымогать)
hide hid hidden - (скрывать, прятать, прятаться)
spend spent spent - тратить
buy bought bought - покупать
wet wet wet - мочить
teach taught taught - обучать
spring sprang sprung - (вскочить, появиться)
catch caught caught - (ловить, поймать)
dig dug dug - копать
sew sewed sewn - шить
awake awoke awoken - (будить, просыпаться)
mistake mistook mistaken - ошибаться
freeze froze frozen - (заморозить, замёрзнуть)
give gave given - давать
bind bound bound - вязать
fling flung flung - (швырять, бросать) передает силу, энергию или небрежность в действии бросания, а также может указывать на эмоциональное состояние или движение сильной интенсивности.
forecast forecast forecast - прогнозировать
spread spread spread - распространять
have had had - иметь
throw threw thrown - (кидать, бросать) указывает на действие бросания с целью или направлением.
tread trod trodden - (ступать, наступать)
think thought thought - думать
speak spoke spoken - говорить
fit fit fit - (подходить по размеру, соответствовать,  быть в хорошей физической форме)
shut shut shut - закрывать
say said said - сказать