buy up - скупать
put something away - убрать что-то
keep in mind - иметь ввиду
warm up - разогревать
try out - проверять
grow out of - расти из
get down to - спускаться
make up - составить
to sum up - подводить итоги
speed up - ускорить
let's talk it over - давайте обсудим это
freak out - взбеситься
to go through - пройти
get on with - ужиться
look into - смотреть в
plug in - подключить
measure up - соответствовать
hang up - вешать трубку
put away - убрать
break out - разразиться
go under - идти под
get in touch with - связаться с
get to know - узнать
think ahead - думай наперед
call for - звать
bump into - врезаться
put together - собрать
heat up - разогреть
reach down - тянуться вниз
take on - взять
leap at - прыгать на
sell out - распродавать
meet up - встретиться
go in for - заниматься
turn into - превратиться в
to overcome - преодолеть
rip off - сдирать
point out - указать
come across - встретить
turn out - оказаться
fall apart - развалиться
work oneself up - работать над собой
get back to - вернуться к
dwell on - остановиться на
get across - перейди
pull it out - вытащить это
show off - выпендриваться
see off - провожать
come down on - спуститься на
ask out - спросить
drift apart - расходиться